35 20
~~~~~#########################~~~~~
~###~#########################~###~
~###~#####~~~~~~###~~~~~~#####~###~
~~~~~#####~####~~~~~####~#####~~~~~
~###~~~~~~~#~~~~###~~~~#~~~~~~~###~
~~~~~~######~##~###~##~######~~~~~~
~####~######~##~~~~~##~######~####~
~~~~~~######~###~#~###~######~~~~~~
~###~###~~~~~###~~~###~~~~~###~###~
~~~~~###~####~~~~#~~~~####~###~~~~~
~#~#~###~####~#######~####~###~#~#~
~~~#~###~~~~~~#######~~~~~~###~#~~~
~#~~~########~#######~########~~~#~
~###~########~#######~########~###~
~~~~~~~~#####~~~###~~~#####~~~~~~~~
~#~##~#~#####~#~###~#~#####~#~##~#~
~~~#~~~~~~~~~~#~###~#~~~~~~~~~~#~~~
~#~#~#######~##~###~##~#######~#~#~
~#~#~#######~##~###~##~#######~#~#~
~~~~~#######~~~~~~~~~~~#######~~~~~