35 20
~~~~~~#######~~~###~~~#######~~~~~~
~####~#######~#~~~~~#~#######~####~
~####~#######~#~###~#~#######~####~
~####~#######~#~###~#~#######~####~
~####~~~~~~~~~~~~~~~~~~~~~~~~~####~
~~~#############################~~~
~#~#############################~#~
~~~#############################~~~
~#~############~~~~~############~#~
~#~############~###~############~#~
~#~######~~~~~~~###~~~~~~~######~#~
~~~######~###############~######~~~
##~~~~~##~###~~~~#~~~~###~##~~~~~##
##~###~##~###~##~#~##~###~##~###~##
##~~~~~~~~~##~##~#~##~##~~~~~~~~~##
##~###~###~##~##~#~##~##~###~###~##
~~~~~~~###~##~##~#~##~##~###~~~~~~~
~##~######~~~~##~#~##~~~~######~##~
~##~######~#####~#~#####~######~##~
~~~~~~~~~~~~~~~~~~~~~~~~~~~~~~~~~~~