35 20
~~~#######~~~~~~~~~~~~~~~#######~~~
~#~#######~##~#######~##~#######~#~
~#~~~~####~##~#######~##~####~~~~#~
~####~~~~~~##~#######~##~~~~~~####~
~####~#######~#######~#######~####~
~####~###~~~~~#######~~~~~###~####~
~####~###~##~#########~##~###~####~
~####~###~##~#########~##~###~####~
~~~##~###~##~#########~##~###~##~~~
~#~##~~~~~##~###~~~###~##~~~~~##~#~
~#~######~##~###~#~###~##~######~#~
~#~######~##~###~#~###~##~######~#~
~#~~~~~~~~~~~~~~~#~~~~~~~~~~~~~~~#~
~~~#####~#######~#~#######~#####~~~
~#######~###~~~~~#~~~~~###~#######~
~#######~###~###~~~###~###~#######~
~####~~~~~~~~###~#~###~~~~~~~~####~
~####~#~####~~~~~~~~~~~####~#~####~
~####~#~####~#########~####~#~####~
~~~~~~~~~~~~~#########~~~~~~~~~~~~~