35 20
~~~~~~~~~#################~~~~~~~~~
~#~#~###~~~~~~~~~~~~~~~~~~~###~#~#~
~~~#~###~###~#########~###~###~#~~~
~###~##~~~~~~~~~~~~~~~~~~~~~##~###~
~~~~~##~###~#~#######~#~###~##~~~~~
####~##~###~~~#######~~~###~##~####
####~##~###~###########~###~##~####
####~##~~~~~####~~~####~~~~~##~####
####~####~#~####~#~####~#~####~####
####~####~#~####~#~####~#~####~####
####~~~~#~#~###~~~~~###~#~#~~~~####
#######~#~#~###~###~###~#~#~#######
#####~~~~~~~~~~~###~~~~~~~~~~~#####
#####~#~######~#####~######~#~#####
##~~~~~~~~~###~#####~###~~~~~~~~~##
##~##~####~~~~~~###~~~~~~####~##~##
##~##~####~####~###~####~####~##~##
~~~~~~####~####~###~####~####~~~~~~
~##~######~##~~~###~~~##~######~##~
~~~~~~~~~~~~~~#######~~~~~~~~~~~~~~