35 20
~~~~~~~~~~~~~~~~~#~~~~~~~~~~~~~~~~~
~###~#####~##~##~#~##~##~#####~###~
~###~#####~##~##~#~##~##~#####~###~
~###~##~~~~~~~~#~#~#~~~~~~~~##~###~
~###~##~####~#~#~#~#~#~####~##~###~
~~~~~~~~~~~~~~~~~~~~~~~~~~~~~~~~~~~
~########~###~##~#~##~###~########~
~########~###~~~~~~~~~###~########~
~########~###~##~#~##~###~########~
~########~###~##~#~##~###~########~
~########~###~~~~~~~~~###~########~
~#######~~~~~~#######~~~~~~#######~
~#######~#~##~#######~##~#~#######~
~#######~#~##~#######~##~#~#######~
~#######~#~##~#######~##~#~#######~
~###~~~#~~~##~~~~~~~~~##~~~#~~~###~
~###~#~~~####~#######~####~~~#~###~
~###~#~#~####~#######~####~#~#~###~
~###~#~#~####~#######~####~#~#~###~
~~~~~~~~~~~~~~#######~~~~~~~~~~~~~~