35 20
~~~~#######~~~~~~~~~~~~~#######~~~~
~##~#######~#~#~###~#~#~#######~##~
~##~#######~#~#~~~~~#~#~#######~##~
~##~#######~#~~~###~~~#~#######~##~
~##~##~~~~~~~~#~###~#~~~~~~~~##~##~
~##~##~########~###~########~##~##~
~~~~~~~########~###~########~~~~~~~
~##~##~######~~~###~~~######~##~##~
~~~~~~~~~~###~#~###~#~###~~~~~~~~~~
##~##~###~###~~~###~~~###~###~##~##
~~~~#~###~###~#~###~#~###~###~#~~~~
~##~#~###~###~#~###~#~###~###~#~##~
~##~~~###~###~#~###~#~###~###~~~##~
~~~~#~~~~~###~#~###~#~###~~~~~#~~~~
~#####~##~###~~~~#~~~~###~##~#####~
~#####~##~######~#~######~##~#####~
~#~~~~~~~~~~####~~~####~~~~~~~~~~#~
~#~########~###########~########~#~
~#~########~###########~########~#~
~~~########~~~~~~~~~~~~~########~~~