35 20
~~~~~#######~~~~~~~~~~~#######~~~~~
~###~###~~~~~~###~###~~~~~~###~###~
~~~~~~~#~####~###~###~####~#~~~~~~~
###~##~#~####~###~###~####~#~##~###
###~##~#~~~~~~~~~~~~~~~~~~~#~##~###
###~~~~~~~####~#~#~#~####~~~~~~~###
####~#~##~####~~~#~~~####~##~#~####
#~~~~#~##~####~#####~####~##~#~~~~#
#~##~#~##~####~#####~####~##~#~##~#
#~#~~~~~~~~~~~~#####~~~~~~~~~~~~#~#
#~#~####~#################~####~#~#
~~~~####~#################~####~~~~
~##~~~~~~~~~~~~~###~~~~~~~~~~~~~##~
~##~###########~###~###########~##~
~~~~###########~###~###########~~~~
~##~###########~###~###########~##~
~##~###########~###~###########~##~
~##~~~#########~~~~~#########~~~##~
~##~#~#########~#~#~#########~#~##~
~~~~~~~~~~~~~~~~~~~~~~~~~~~~~~~~~~~