35 20
~~~~~~~#~~~~~~##~~~##~~~~~~#~~~~~~~
~#####~~~####~##~#~##~####~~~#####~
~###~~~#~####~##~#~##~####~#~~~###~
~###~#~~~####~~~~#~~~~####~~~#~###~
~~~~~~##~~~~~~#######~~~~~~##~~~~~~
~####~##~#~##~#######~##~#~##~####~
~####~##~#~##~#######~##~#~##~####~
~####~~~~#~##~~~~~~~~~##~#~~~~####~
~####~##~~~###~#####~###~~~##~####~
~~~##~####~###~#####~###~####~##~~~
##~##~####~###~~~~~~~###~####~##~##
##~~~~####~###~#####~###~####~~~~##
##~#######~###~#####~###~#######~##
##~#######~###~#####~###~#######~##
~~~~######~###~#####~###~######~~~~
~##~~~~~~~~~~~~~~~~~~~~~~~~~~~~~##~
~##~#########~#~###~#~#########~##~
~##~######~~~~~~###~~~~~~######~##~
~##~######~#~##~###~##~#~######~##~
~~~~######~~~~~~~~~~~~~~~######~~~~