35 20
~~~~#####~~~~~~~~~~~~~~~~~#####~~~~
~##~##~~~~##~####~####~##~~~~##~##~
~##~##~##~~~~####~####~~~~##~##~##~
~##~~~~##~##~~~~~~~~~~~##~##~~~~##~
~########~####~#~#~#~####~########~
~######~~~~~~~~#~#~#~~~~~~~~######~
~~~####~#~######~#~######~#~####~~~
~#~~~~~~~~######~~~######~~~~~~~~#~
~#~######~###############~######~#~
~~~######~~~~#########~~~~######~~~
~#~#########~#########~#########~#~
~~~#########~#########~#########~~~
~###########~#########~###########~
~~~~########~#########~########~~~~
~##~########~#########~########~##~
~##~########~#########~########~##~
~~~~~~~~~~~~~#########~~~~~~~~~~~~~
~##~##~##~###############~##~##~##~
~##~##~##~~~~~~~~~~~~~~~~~##~##~##~
~~~~~~~~~~###############~~~~~~~~~~