35 20
~~~~~~#####~~~~~###~~~~~#####~~~~~~
~##~#~#####~#~#~###~#~#~#####~#~##~
~##~#~#####~#~#~###~#~#~#####~#~##~
~##~~~####~~~~#~~~~~#~~~~####~~~##~
~##~#~~~~~~#####~#~#####~~~~~~#~##~
~~~~~~####~#####~#~#####~####~~~~~~
~#########~#####~~~#####~#########~
~#########~#############~#########~
~#########~#############~#########~
~#########~#############~#########~
~~~~~~####~#############~####~~~~~~
~####~~~~~~#############~~~~~~####~
~~~~~~#~#~###############~#~#~~~~~~
#####~#~~~~#############~~~~#~#####
#####~~~##~#############~##~~~#####
#####~#~##~#############~##~#~#####
~~~~~~~~~~~~~~~~~#~~~~~~~~~~~~~~~~~
~###~###~##~##~#~~~#~##~##~###~###~
~###~###~##~~~~#~#~#~~~~##~###~###~
~~~~~~~~~~~~#~~~~~~~~~#~~~~~~~~~~~~