35 20
~~~#######~~~~~~###~~~~~~#######~~~
~#~#######~####~###~####~#######~#~
~~~~~~~~~~~####~~~~~####~~~~~~~~~~~
~#~#############################~#~
~#~#############################~#~
~~~#############################~~~
~#~~~~#######################~~~~#~
~#~##~#######################~##~#~
~#~~~~#######################~~~~#~
~~~#~####~~~~#########~~~~####~#~~~
~#~~~####~##~#########~##~####~~~#~
~~~######~##~#########~##~######~~~
~#~~~~~~~~##~#~~~~~~~#~##~~~~~~~~#~
~#~#########~#~#####~#~#########~#~
~~~#########~#~#~~~#~#~#########~~~
~#~#########~~~~~#~~~~~#########~#~
~~~##########~##~#~##~##########~~~
~#~~~~~~~~~~~~##~#~##~~~~~~~~~~~~#~
~####~##~#~##~##~#~##~##~#~##~####~
~~~~~~~~~~~##~~~~~~~~~##~~~~~~~~~~~