35 20
~~~~~~~~~~~~~~~~~~~~~~~~~~~~~~~~~~~
~#~###~##~#~#~##~#~##~#~#~##~###~#~
~#~~~~~##~~~#~##~#~##~#~~~##~~~~~#~
~############~##~~~##~############~
~############~#######~############~
~############~#######~############~
~############~#######~############~
~############~#######~############~
~~~##########~#######~##########~~~
~#~##########~#######~##########~#~
~~~~~~#######~#######~#######~~~~~~
~#~##~#######~~~~~~~~~#######~##~#~
~#~##~~~~~~~~~#######~~~~~~~~~##~#~
~~~##~##~#~#~#########~#~#~##~##~~~
~##~~~##~#~#~#########~#~#~##~~~##~
~~~~#~~~~~~~~#########~~~~~~~~#~~~~
~##~#~####~#~#########~#~####~#~##~
~~~~~~####~~~#########~~~####~~~~~~
~##~#~####~#~#########~#~####~#~##~
~~~~~~~~~~~~~~~~~~~~~~~~~~~~~~~~~~~