35 20
~~~~~~~~~~~~~#########~~~~~~~~~~~~~
~#~#~##~####~~~~~~~~~~~####~##~#~#~
~#~~~##~####~#########~####~##~~~#~
~~~#~~~~~~~~~~~~~~~~~~~~~~~~~~~#~~~
~#~#~##~####~#########~####~##~#~#~
~#~#~##~~~~~~#########~~~~~~##~#~#~
~~~~~~~#~#################~#~~~~~~~
~##~##~~~#################~~~##~##~
~~~~~~~#####################~~~~~~~
###~##~~~~~~~#########~~~~~~~##~###
###~########~#~~~~~~~#~########~###
###~########~#~#####~#~########~###
###~########~~~~~~~~~~~########~###
#~~~##########~#####~##########~~~#
#~#~~~~~######~#####~######~~~~~#~#
#~###~#~######~#####~######~#~###~#
~~~~~~~~######~#####~######~~~~~~~~
~####~#~######~#####~######~#~####~
~####~#~~~~~##~#####~##~~~~~#~####~
~~~~~~~~###~~~~#####~~~~###~~~~~~~~