35 20
~~~~#####~~~~~~~~~~~~~~~~~#####~~~~
~##~#####~###############~#####~##~
~##~#####~###############~#####~##~
~##~~~~~~~~~~#########~~~~~~~~~~##~
~#########~#~#########~#~#########~
~#########~#~#########~#~#########~
~~~~~~~~~~~#~#########~#~~~~~~~~~~~
~####~######~#########~######~####~
~~~##~######~~~~~~~~~~~######~##~~~
~#~##~######~#########~######~##~#~
~#~~~~######~#########~######~~~~#~
~####~###~~~~#########~~~~###~####~
~~~~~~###~#~###########~#~###~~~~~~
~###~####~#~###########~#~####~###~
~###~####~#~###########~#~####~###~
~###~####~#~~~~~~~~~~~~~#~####~###~
~~~~~####~##~#########~##~####~~~~~
~###~##~~~~~~#########~~~~~~##~###~
~###~##~#~##~#########~##~#~##~###~
~~~~~~~~#~~~~~~~~~~~~~~~~~#~~~~~~~~