35 20
~~~~~##~~~~~~~~~~~~~~~~~~~~~##~~~~~
~###~##~###################~##~###~
~###~~~~~~###############~~~~~~###~
~####~###~###############~###~####~
~####~###~###############~###~####~
~~~~~~~~~~##~~~~~#~~~~~##~~~~~~~~~~
~###~####~##~###~#~###~##~####~###~
~~~~~~~~#~~~~###~#~###~~~~#~~~~~~~~
~##~###~####~###~#~###~####~###~##~
~##~###~####~###~~~###~####~###~##~
~##~~~~~####~#########~####~~~~~##~
~~~~###~~~~~~~~#####~~~~~~~~###~~~~
###~#######~##~#####~##~#######~###
###~~~~~~##~##~#####~##~##~~~~~~###
###~####~##~~~~#####~~~~##~####~###
###~####~~~~##~#####~##~~~~####~###
###~####~##~~~~~~~~~~~~~##~####~###
~~~~####~####~#######~####~####~~~~
~##~~~~~~####~#######~####~~~~~~##~
~~~~#########~~~~~~~~~#########~~~~