35 20
~~~~~~~~###~~~~~~~~~~~~~###~~~~~~~~
~#~##~#~~~#~###########~#~~~#~##~#~
~#~#~~~~#~~~~~~~~~~~~~~~~~#~~~~#~#~
~~~~~#~##~###############~##~#~~~~~
####~#~##~###############~##~#~####
####~~~~~~###############~~~~~~####
####~##~#~###############~#~##~####
####~##~#~###############~#~##~####
##~~~~~~~~~~###########~~~~~~~~~~##
##~#~#~#~##~###########~##~#~#~#~##
~~~#~#~#~##~###########~##~#~#~#~~~
~#~~~~~~~~~~~~~~~~~~~~~~~~~~~~~~~#~
~~~##~####~#~##~###~##~#~####~##~~~
~#~~~~####~~~~~~~~~~~~~~~####~~~~#~
~#~##~#######################~##~#~
~#~##~#######################~##~#~
~#~##~~~~#################~~~~##~#~
~#~~~~##~#################~##~~~~#~
~#~#####~#################~#####~#~
~~~~~~~~~#################~~~~~~~~~