35 20
~~~~~###~~~~~~~~~~~~~~~~~~~###~~~~~
~#~#~~~~~###~#########~###~~~~~#~#~
~#~#~#######~#########~#######~#~#~
~#~~~#######~#########~#######~~~#~
~~~#~###~~~~~~~~~#~~~~~~~~~###~#~~~
~###~###~##~#~##~#~##~#~##~###~###~
~###~###~~~~#~##~#~##~#~~~~###~###~
~#~~~########~##~~~##~########~~~#~
~#~##########~~~~#~~~~##########~#~
~~~#############################~~~
~#################################~
~#####~~~~~~~~~#####~~~~~~~~~#####~
~~~###~#######~#####~#######~###~~~
~#~~~~~#######~#~~~#~#######~~~~~#~
~~~#~#~#######~#~#~#~#######~#~#~~~
##~#~#~######~~~~~~~~~######~#~#~##
~~~~~#~######~##~#~##~######~#~~~~~
~#~###~######~##~#~##~######~###~#~
~#~###~######~~~~#~~~~######~###~#~
~~~~~~~~~~~~~~#######~~~~~~~~~~~~~~