35 20
~~~~~~#####~~~~~~~~~~~~~#####~~~~~~
~####~#####~###########~#####~####~
~~~~~~#####~###########~#####~~~~~~
~#~##~#####~###########~#####~##~#~
~~~##~~~~~~~~~~~~~~~~~~~~~~~~~##~~~
~######~######~#####~######~######~
~######~######~#####~######~######~
~######~######~#~~~#~######~######~
~~~~###~######~~~#~~~######~###~~~~
~##~###~########~#~########~###~##~
~~~~~~#~########~#~########~#~~~~~~
##~##~#~~~~#####~#~#####~~~~#~##~##
##~##~~~##~#####~#~#####~##~~~##~##
##~##~####~#####~#~#####~####~##~##
##~##~####~###~~~#~~~###~####~##~##
##~##~####~~~~~#####~~~~~####~##~##
##~##~########~#####~########~##~##
~~~~~~~#######~#####~#######~~~~~~~
~###~#~~~~~###~~~~~~~###~~~~~#~###~
~~~~~~~###~~~~~#####~~~~~###~~~~~~~