35 20
~~~~~~~~~~~~~~~~~~~~~~~~~~~~~~~~~~~
~#~######~######~#~######~######~#~
~~~~~####~######~#~######~####~~~~~
~###~~~~~~######~#~######~~~~~~###~
~~~~~###########~#~###########~~~~~
~###~###########~~~###########~###~
~###~#########################~###~
~~~~~~~~~~~~###########~~~~~~~~~~~~
~###~######~###########~######~###~
~~~#~#####~~~~~~~~~~~~~~~#####~#~~~
~#~#~#####~#############~#####~#~#~
~~~~~#####~#############~#####~~~~~
~#~#~~~~~#~#############~#~~~~~#~#~
~#~#~###~#~#############~#~###~#~#~
~#~#~###~#~#############~#~###~#~#~
~#~#~###~~~#############~~~###~#~#~
~#~~~~~~~#~#############~#~~~~~~~#~
~~~###~#~#~#############~#~#~###~~~
~#####~#~#~#############~#~#~#####~
~~~~~~~~~~~~~~~~~~~~~~~~~~~~~~~~~~~