35 20
~~~~~~~~~~~~###########~~~~~~~~~~~~
~##########~###########~##########~
~##########~~~~#####~~~~##########~
~~~~~~~~~~~~##~#####~##~~~~~~~~~~~~
~####~#####~##~#####~##~#####~####~
~####~#####~~~~~~~~~~~~~#####~####~
~####~#######################~####~
~####~#######################~####~
~~~~~~~~~~###############~~~~~~~~~~
~##~#####~###############~#####~##~
~##~#####~###############~#####~##~
~~~~~~###~###############~###~~~~~~
~##~#~###~###############~###~#~##~
~~~~#~###~~~~~~~~~~~~~~~~~###~#~~~~
~##~~~########~#####~########~~~##~
~##~#~########~~~~~~~########~#~##~
~~~~~~~~####~~~#####~~~####~~~~~~~~
~###~##~####~#~~~~~~~#~####~##~###~
~###~##~####~#~#####~#~####~##~###~
~~~~~~~~####~~~#####~~~####~~~~~~~~