35 20
~~~~~~~~~~~~~#~~~#~~~#~~~~~~~~~~~~~
~###########~#~#~#~#~#~###########~
~###########~#~#~#~#~#~###########~
~##########~~~~~~~~~~~~~##########~
~#######~~~~#~#######~#~~~~#######~
~~~~####~##~#~#######~#~##~####~~~~
###~####~##~#~#######~#~##~####~###
###~####~~~~~~~~~~~~~~~~~~~####~###
###~#######~#~#######~#~#######~###
###~~~#####~#~#######~#~#####~~~###
#####~##~~~~~~#######~~~~~~##~#####
#####~##~#~##~#######~##~#~##~#####
#####~##~#~##~#######~##~#~##~#####
~~~~~~##~#~##~#######~##~#~##~~~~~~
~#######~#~##~~~~#~~~~##~#~#######~
~~~#####~~~~~~##~#~##~~~~~~#####~~~
~#~#####~####~##~#~##~####~#####~#~
~#~#####~####~##~~~##~####~#####~#~
~#~#####~####~##~#~##~####~#####~#~
~~~~~~~~~~~~~~~~~~~~~~~~~~~~~~~~~~~