35 20
~~~~~#########################~~~~~
~###~#########################~###~
~###~~~~~~###############~~~~~~###~
~~~~~#~##~###############~##~#~~~~~
~#~###~##~##~~~~~~~~~~~##~##~###~#~
~#~###~##~~~~#########~~~~##~###~#~
~#~###~##~##~~~~~~~~~~~##~##~###~#~
~~~~##~##~##~#########~##~##~##~~~~
~##~~~~~~~##~#########~##~~~~~~~##~
~##~#~###~~~~#########~~~~###~#~##~
~##~#~###~###############~###~#~##~
~~~~~~~~~~###############~~~~~~~~~~
~#~#~##~#~###############~#~##~#~#~
~~~~~~~~#~###############~#~~~~~~~~
~#~###~##~~~###########~~~##~###~#~
~~~~~~~####~~~~~~#~~~~~~####~~~~~~~
~##~#~~~~~~~##~#~#~#~##~~~~~~~#~##~
~##~#~#####~##~~~~~~~##~#####~#~##~
~##~#~#####~##~#####~##~#####~#~##~
~~~~~~#####~~~~~~~~~~~~~#####~~~~~~