35 20
~~~~~~~~~~###############~~~~~~~~~~
~#~##~#~#~~~~~~~~~~~~~~~~~#~#~##~#~
~#~~~~#~######~#####~######~#~~~~#~
~#~##~~~~#####~#####~#####~~~~##~#~
~~~~~~~#~#####~#####~#####~#~~~~~~~
~#####~#~##~~~~#####~~~~##~#~#####~
~#####~~~##~###########~##~~~#####~
~#####~####~###########~####~#####~
~~~~~~~####~###########~####~~~~~~~
~####~#####~###########~#####~####~
~####~~~~~~~~~~~~~~~~~~~~~~~~~####~
~~~~~~######~#########~######~~~~~~
~###########~#########~###########~
~###########~#########~###########~
~###########~#########~###########~
~#######~~~~~~#######~~~~~~#######~
~#######~####~~~~~~~~~####~#######~
~####~~~~~~~~~#######~~~~~~~~~####~
~####~##~####~#######~####~##~####~
~~~~~~##~~~~~~~~~~~~~~~~~~~##~~~~~~