35 20
~~~~~~###~~~###########~~~###~~~~~~
~####~###~#~###########~#~###~####~
~####~###~~~~~~~~~~~~~~~~~###~####~
~~~~~~~~~~#~##~#####~##~#~~~~~~~~~~
~####~#~#~~~~#~#####~#~~~~#~#~####~
~~~##~#~#~##~~~~~~~~~~~##~#~#~##~~~
~#~##~#~#~##~#~#####~#~##~#~#~##~#~
~~~##~~~~~~~~#~#####~#~~~~~~~~##~~~
#~####~###~###~#####~###~###~####~#
#~####~###~###~#####~###~###~####~#
#~~~~~~###~###~~~~~~~###~###~~~~~~#
#~####~###~###~#####~###~###~####~#
~~~~~~~~~~~~~~~~~~~~~~~~~~~~~~~~~~~
~#~##~#####~###########~#####~##~#~
~#~#~~~~~~~~###########~~~~~~~~#~#~
~#~#~#~#####################~#~#~#~
~#~~~#~#####################~#~~~#~
~~~#~#~#####################~#~#~~~
~###~#~#####################~#~###~
~~~~~~~#####################~~~~~~~