35 20
~~~~~~~~~~~~~~#######~~~~~~~~~~~~~~
~#######~##~#~#######~#~##~#######~
~####~~~~##~#~~~~#~~~~#~##~~~~####~
~####~##~##~####~#~####~##~##~####~
~####~##~##~####~#~####~##~##~####~
~~~~~~##~~~~~~~#~#~#~~~~~~~##~~~~~~
~#######~###~#~#~~~#~#~###~#######~
~#######~###~#~~~#~~~#~###~#######~
~#######~###~#########~###~#######~
~#######~###~#########~###~#######~
~~~~~~~~~###~#########~###~~~~~~~~~
###~####~###~#########~###~####~###
###~~~~~~###~#########~###~~~~~~###
###~#~######~#########~######~#~###
###~#~~~~~~~~~~~~~~~~~~~~~~~~~#~###
###~########~#########~########~###
###~########~#########~########~###
~~~~~#######~~~~~~~~~~~#######~~~~~
~###~~~~~~~##~#######~##~~~~~~~###~
~~~~~#####~~~~~~~~~~~~~~~#####~~~~~