35 20
~~~~~~~~~~~~~~~~~~~~~~~~~~~~~~~~~~~
~###~#~#~#################~#~#~###~
~~~~~~~~~#################~~~~~~~~~
#######~###################~#######
#######~###################~#######
#######~###################~#######
#######~###################~#######
#######~~~~~~~~~~~~~~~~~~~~~#######
########~##~#~#~###~#~#~##~########
########~~~~#~~~~~~~~~#~~~~########
########~##~#~#######~#~##~########
###~~~~~~##~#~#######~#~##~~~~~~###
###~####~##~#~#######~#~##~####~###
###~~~~~~##~#~#######~#~##~~~~~~###
######~#~##~#~#######~#~##~#~######
~~~~~~~~~~~~#~#######~#~~~~~~~~~~~~
~##~###~#~#~~~~~~~~~~~~~#~#~###~##~
~~~~###~#~#~##~#~#~#~##~#~#~###~~~~
~##~###~#~#~~~~~~#~~~~~~#~#~###~##~
~~~~~~~~~~~~###########~~~~~~~~~~~~