35 20
~~~~#~~~~#################~~~~#~~~~
~##~~~##~#################~##~~~##~
~##~#~##~#################~##~#~##~
~~~~#~##~#################~##~#~~~~
~##~#~##~#################~##~#~##~
~~~~#~##~#################~##~#~~~~
~####~#~~~~~~#########~~~~~~#~####~
~~~~~~#~####~###~~~###~####~#~~~~~~
~######~~~##~###~#~###~##~~~######~
~###~~~~#~##~~~~~#~~~~~##~#~~~~###~
~###~##~#~##~#~#####~#~##~#~##~###~
~~~~~##~#~##~#~#####~#~##~#~##~~~~~
~######~~~~~~#~~~~~~~#~~~~~~######~
~###########~#########~###########~
~###########~#########~###########~
~###~~~~~~~~~~~~~~~~~~~~~~~~~~~###~
~###~#~##~#~###########~#~##~#~###~
~###~#~##~#~###########~#~##~#~###~
~###~#~##~#~###########~#~##~#~###~
~~~~~~~~~~~~~~~~~~~~~~~~~~~~~~~~~~~