35 20
~~~~~~~~~~##~~~~~~~~~~~##~~~~~~~~~~
~#~#~####~##~###~#~###~##~####~#~#~
~~~~~~~~~~~~~~~~~~~~~~~~~~~~~~~~~~~
####~#####~###~#~#~#~###~#####~####
####~#####~~~~~#~#~#~~~~~#####~####
####~#########~#~#~#~#########~####
####~#########~#~#~#~#########~####
####~#########~~~~~~~#########~####
####~############~############~####
~~~~~~~~~~~~~####~####~~~~~~~~~~~~~
~##~###~####~####~####~####~###~##~
~##~###~####~####~####~####~###~##~
~##~###~####~###~~~###~####~###~##~
~~~~###~####~###~#~###~####~###~~~~
~######~~~##~~~~~~~~~~~##~~~######~
~~~~~~~~#~###############~#~~~~~~~~
~######~#~###############~#~######~
~######~#~###############~#~######~
~######~#~###############~#~######~
~~~~~~~~~~###############~~~~~~~~~~