35 20
~~~~~~~~~~###############~~~~~~~~~~
~#~#~####~~~~~~#####~~~~~~####~#~#~
~~~~~####~####~#####~####~####~~~~~
~#~#~####~####~#####~####~####~#~#~
~#~~~####~####~#####~####~####~~~#~
~###~####~####~#####~####~####~###~
~###~~~~~~####~~~~~~~####~~~~~~###~
~###~####~~~~~~#####~~~~~~####~###~
~###~######~##~#####~##~######~###~
~###~#~~~~~~~~~#####~~~~~~~~~#~###~
~#~~~#~##~###############~##~#~~~#~
~~~###~##~###############~##~###~~~
~#~###~##~##~~~~###~~~~##~##~###~#~
~~~#~~~##~##~##~###~##~##~##~~~#~~~
~###~####~##~##~~~~~##~##~####~###~
~###~####~##~##~###~##~##~####~###~
~~~~~~~~~~~~~~#~~~~~#~~~~~~~~~~~~~~
~###~########~#~###~#~########~###~
~###~########~~~~~~~~~########~###~
~~~~~#########################~~~~~