35 20
~~~~~~~~##~~~~~~~~~~~~~~~##~~~~~~~~
~######~~~~####~###~####~~~~######~
~~~####~#######~###~#######~####~~~
~#~####~#######~###~#######~####~#~
~#~####~~~~~###~###~###~~~~~####~#~
~~~########~###~~~~~###~########~~~
##~########~###########~########~##
##~########~~~#######~~~########~##
~~~~#######~#~#~~~~~#~#~#######~~~~
~##~#######~~~#~#~#~#~~~#######~##~
~~~~#~~~~~~~###~#~#~###~~~~~~~#~~~~
~####~#####~###~#~#~###~#####~####~
~####~#####~~~~~#~#~~~~~#####~####~
~####~###########~###########~####~
~####~###~~~#####~#####~~~###~####~
~####~~~~~#~#####~#####~#~~~~~####~
~########~#~###~~~~~###~#~########~
~~~~#####~#~###~#~#~###~#~#####~~~~
~##~#####~#~###~#~#~###~#~#####~##~
~~~~~~~~~~~~~~~~~~~~~~~~~~~~~~~~~~~