35 20
~~~~~~~~~~~~~~~~~~~~~~~~~~~~~~~~~~~
~####~#~##~####~###~####~##~#~####~
~####~#~~~~~~~~~###~~~~~~~~~#~####~
~~~~~~~###~#############~###~~~~~~~
#~##~#~~~~~~~~~~~~~~~~~~~~~~~#~##~#
#~#~~~~########~###~########~~~~#~#
#~#~##~~~~~~~~~~~~~~~~~~~~~~~##~#~#
#~~~~~~###~##~#######~##~###~~~~~~#
###~##~###~~~~#######~~~~###~##~###
~~~~~#~######~#######~######~#~~~~~
~###~#~######~#######~######~#~###~
~~~~~#~######~~~~~~~~~######~#~~~~~
~#~#~~~#####################~~~#~#~
~~~~~#~#####################~#~~~~~
~###~~~#####################~~~###~
~~~~~#########################~~~~~
~###~#########################~###~
~~~~~#########################~~~~~
~###~#########################~###~
~~~~~#########################~~~~~