35 20
~~~~~~~~###################~~~~~~~~
~###~##~###################~##~###~
~###~##~###################~##~###~
~###~~~~~~~~~~~~~~~~~~~~~~~~~~~###~
~##########~##~#~#~#~##~##########~
~##########~##~~~#~~~##~##########~
~##########~###########~##########~
~~~~~~~~~~~~###########~~~~~~~~~~~~
~##########~###########~##########~
~##########~###########~##########~
~#####~~~~~~##~~~~~~~##~~~~~~#####~
~~~~~~~#######~#####~#######~~~~~~~
~#####~~~~~~~~~~~~~~~~~~~~~~~#####~
~#~~~~~######~#######~######~~~~~#~
~#~##########~#######~##########~#~
~#~##########~#######~##########~#~
~#~##########~#######~##########~#~
~#~~~~~~##~~~~~~~~~~~~~~~##~~~~~~#~
~#~####~##~####~###~####~##~####~#~
~~~####~~~~~~~~~~~~~~~~~~~~~####~~~