35 20
~~~~~~~~~~~~#~~~~~~~~~#~~~~~~~~~~~~
~##~#~###~#~#~###~###~#~#~###~#~##~
~##~#~###~#~~~###~###~~~#~###~#~##~
~##~#~###~##~#~~~~~~~#~##~###~#~##~
~##~~~###~##~#~#~#~#~#~##~###~~~##~
~~~~#~###~##~#~#~#~#~#~##~###~#~~~~
~####~###~##~~~#~#~#~~~##~###~####~
~~~~~~###~###~##~#~##~###~###~~~~~~
#####~###~###~##~#~##~###~###~#####
#####~~~~~~##~##~#~##~##~~~~~~#####
#####~####~##~##~#~##~##~####~#####
#####~####~##~##~#~##~##~####~#####
~~~~~~####~##~##~#~##~##~####~~~~~~
~####~####~##~##~~~##~##~####~####~
~####~####~~~~##~#~##~~~~####~####~
~####~##########~#~##########~####~
~~~~~~##########~#~##########~~~~~~
~##~############~#~############~##~
~##~############~#~############~##~
~~~~~~~~~~~~~~~~~~~~~~~~~~~~~~~~~~~