35 20
~~~~~~~~~#######~~~#######~~~~~~~~~
~#~#~###~##~~~~~~#~~~~~~##~###~#~#~
~~~#~~~~~~~~###########~~~~~~~~#~~~
~#~#~######~~~~~~~~~~~~~######~#~#~
~#~~~#########~#~#~#~#########~~~#~
~~~#~#########~#~#~#~#########~#~~~
~###~#########~~~#~~~#########~###~
~~~~~~~~~~####~#~~~#~####~~~~~~~~~~
#####~###~~~~~~~~#~~~~~~~~###~#####
#####~#~~~###~##~#~##~###~~~#~#####
#####~#~#~###~##~#~##~###~#~#~#####
#####~#~~~###~##~#~##~###~~~#~#####
~~~~~~~~#~###~##~#~##~###~#~~~~~~~~
~########~###~##~#~##~###~########~
~####~~~~~~~~~~~~~~~~~~~~~~~~~####~
~####~#~#######~###~#######~#~####~
~####~~~#######~~~~~#######~~~####~
~~~~~~#######################~~~~~~
~####~#######################~####~
~~~~~~#######################~~~~~~