35 20
~~~#############################~~~
~#~#############################~#~
~#~##~~~~~~~~~~~~~~~~~~~~~~~~~##~#~
~#~##~########~#####~########~##~#~
~#~##~########~~~#~~~########~##~#~
~~~~#~~~~~~~~~~#~#~#~~~~~~~~~~#~~~~
~##~~~~#######~#~#~#~#######~~~~##~
~##~##~#######~#~#~#~#######~##~##~
~~~~##~#######~#~~~#~#######~##~~~~
~##~##~#######~~~#~~~#######~##~##~
~#~~~~~~######~#~#~#~######~~~~~~#~
~#~####~######~~~#~~~######~####~#~
~#~####~~~~~~~~#~#~#~~~~~~~~####~#~
~~~~~~~~######~~~#~~~######~~~~~~~~
~###############~~~###############~
~~~~~###########~#~###########~~~~~
~###~###########~#~###########~###~
~###~~~~~~~~####~#~####~~~~~~~~###~
~####~#####~####~#~####~#####~####~
~~~~~~#####~~~~~~~~~~~~~#####~~~~~~