35 20
~~~~~~~~###################~~~~~~~~
~##~#~#~###################~#~#~##~
~##~#~#~###################~#~#~##~
~##~#~#~###################~#~#~##~
~~~~~~#~###################~#~~~~~~
~####~~~###################~~~####~
~#~~~~#######################~~~~#~
~~~##~~~~~~~~~~~~~~~~~~~~~~~~~##~~~
~#~##~######~##~###~##~######~##~#~
~#~##~~~~~##~##~###~##~##~~~~~##~#~
~~~##~#~#~##~##~~~~~##~##~#~#~##~~~
~#~##~~~~~~~~#########~~~~~~~~##~#~
~#~~~~##~###~#~~~~~~~#~###~##~~~~#~
~~~##~~~~###~#~#~#~#~#~###~~~~##~~~
~#~##~######~#~#~#~#~#~######~##~#~
~#~~~~~~~~~~~~~#~#~#~~~~~~~~~~~~~#~
~###~#~####~##~#~#~#~##~####~#~###~
~###~#~####~##~#~~~#~##~####~#~###~
~###~#~####~~~~#####~~~~####~#~###~
~~~~~~~#####################~~~~~~~