35 20
~~~~~~###~~~###########~~~###~~~~~~
~####~###~#~###########~#~###~####~
~####~###~~~#~~~~~~~~~#~~~###~####~
~####~###~#~#~#######~#~#~###~####~
~####~~~~~#~~~#######~~~#~~~~~####~
~~~~~########~#######~########~~~~~
~###~##~~~~~~~~~~~~~~~~~~~~~##~###~
~~~#~##~#~###############~#~##~#~~~
~#~~~##~#~###############~#~##~~~#~
~~~#~##~#~###############~#~##~#~~~
~##~~~~~~~~#############~~~~~~~~##~
~##~######~#############~######~##~
~##~######~#############~######~##~
~##~######~#############~######~##~
~~~~~~~~~~~#############~~~~~~~~~~~
~#####~###~~~~~~~~~~~~~~~###~#####~
~#####~###~#############~###~#####~
~#####~###~#############~###~#####~
~#####~~~~~#############~~~~~#####~
~~~~~~~###~~~~~~~~~~~~~~~###~~~~~~~