35 20
~~~~~~~~~~~~~~~~~~~~~~~~~~~~~~~~~~~
~##~#~#########~###~#########~#~##~
~##~#~#########~###~#########~#~##~
~##~#~#########~###~#########~#~##~
~##~#~#########~###~#########~#~##~
~##~#~#########~###~#########~#~##~
~##~#~~~~~~####~~~~~####~~~~~~#~##~
~##~~~####~#############~####~~~##~
~~~~#~####~#############~####~#~~~~
~##~~~~~~~~~~~~~~~~~~~~~~~~~~~~~##~
~##~#~#~#~###############~#~#~#~##~
~~~~#~#~#~###############~#~#~#~~~~
###~#~#~#~###############~#~#~#~###
###~#~#~#~###############~#~#~#~###
###~#~#~#~~~~#########~~~~#~#~#~###
~~~~#~#~~~##~#########~##~~~#~#~~~~
~##~~~~~####~#########~####~~~~~##~
~######~####~~~~~~~~~~~####~######~
~######~###################~######~
~~~~~~~~###################~~~~~~~~