35 20
~~~~~#~~~~~~~#########~~~~~~~#~~~~~
~###~#~###~#~#########~#~###~#~###~
~###~#~###~#~#########~#~###~#~###~
~##~~~~###~#~#########~#~###~~~~##~
~##~######~#~~~~~~~~~~~#~######~##~
~~~~~~####~~~#########~~~####~~~~~~
~#~##~~~~~~#~#########~#~~~~~~##~#~
~~~~~~#~##~#~#########~#~##~#~~~~~~
~######~~~~#~#########~#~~~~######~
~#########~~~#########~~~#########~
~#########~#~###~~~###~#~#########~
~#########~#~###~#~###~#~#########~
~#########~#~###~#~###~#~#########~
~#########~#~###~#~###~#~#########~
~#########~#~###~#~###~#~#########~
~~~~~~~~~~~#~~~#~#~#~~~#~~~~~~~~~~~
~#~#######~#~#~#~#~#~#~#~#######~#~
~#~####~~~~#~~~~~~~~~~~#~~~~####~#~
~#~####~##~###~#####~###~##~####~#~
~~~~~~~~~~~###~~~~~~~###~~~~~~~~~~~