35 20
~~~~~~~~~~~~~~~~~~~~~~~~~~~~~~~~~~~
~####~######~###~#~###~######~####~
~~~~~~~~~~~~~~~~~~~~~~~~~~~~~~~~~~~
~####~###~#~#~#######~#~#~###~####~
~####~###~#~#~~~~#~~~~#~#~###~####~
~####~###~#~~~##~#~##~~~#~###~####~
~####~###~#~#~##~#~##~#~#~###~####~
~####~~~~~#~#~~~~~~~~~#~#~~~~~####~
~########~#~~~#######~~~#~########~
~######~~~~~#~#######~#~~~~~######~
~~~~~##~#~###~~~~~~~~~###~#~##~~~~~
~###~##~#~###############~#~##~###~
~~~~~~~~#~###############~#~~~~~~~~
~###~##~~~###############~~~##~###~
~###~#########################~###~
~~~~~#########################~~~~~
~##~###########################~##~
~~~~~#########################~~~~~
~#~#~#########################~#~#~
~~~~~#########################~~~~~