35 20
~~~~~~~#####################~~~~~~~
~#####~~~~~~~#########~~~~~~~#####~
~#####~#####~#########~#####~#####~
~#####~#####~#########~#####~#####~
~#####~#####~#########~#####~#####~
~#####~#####~#########~#####~#####~
~#####~##~~~~~~#####~~~~~~##~#####~
~~~###~##~####~#####~####~##~###~~~
~#~###~~~~~~~~~~~~~~~~~~~~~~~###~#~
~#~###~##~###~#######~###~##~###~#~
~#~~~~~##~###~#######~###~##~~~~~#~
~~~###~~~~###~~~~~~~~~###~~~~###~~~
~#~~~~~######~#######~######~~~~~#~
~~~####~~~~~~~~~~~~~~~~~~~~~####~~~
~#~####~#######~###~#######~####~#~
~#~~~~~~#######~###~#######~~~~~~#~
~#~##~#~#######~###~#######~#~##~#~
~#~##~#~#######~###~#######~#~##~#~
~#~##~#~#######~###~#######~#~##~#~
~~~~~~~~#######~~~~~#######~~~~~~~~