35 20
~~~~~~##~~~~~~~~~~~~~~~~~~~##~~~~~~
~##~#~##~####~#~###~#~####~##~#~##~
~~~~~~##~##~~~~~###~~~~~##~##~~~~~~
~####~##~~~~#~#~###~#~#~~~~##~####~
~####~#####~~~~~###~~~~~#####~####~
~####~#####~###########~#####~####~
~~~~~~~~~~~~~~#######~~~~~~~~~~~~~~
~########~###~#######~###~########~
~########~###~#######~###~########~
~########~###~#######~###~########~
~#####~~~~~~~~#######~~~~~~~~#####~
~#####~###~##~~~~~~~~~##~###~#####~
~~~###~~~~~#############~~~~~###~~~
##~###~##~###############~##~###~##
##~##~~~~~~~~#########~~~~~~~~##~##
##~##~######~##~~~~~##~######~##~##
##~##~######~##~###~##~######~##~##
~~~##~######~##~###~##~######~##~~~
~#~##~######~~~~~#~~~~~######~##~#~
~~~~~~##########~~~##########~~~~~~