35 20
~~~#############################~~~
~#~#############################~#~
~~~#############################~~~
~#~#############################~#~
~#~#############################~#~
~~~~~~~~###################~~~~~~~~
~##~###~###################~###~##~
~##~###~###################~###~##~
~##~~~~~####~~~~~~~~~~~####~~~~~##~
~~~####~####~#########~####~####~~~
~#~~~~#~####~#########~####~#~~~~#~
~#~##~#~####~#########~####~#~##~#~
~#~~~~~~####~~~~~~~~~~~####~~~~~~#~
~#~#~##~~~~~~###~#~###~~~~~~##~#~#~
~~~#~~~~####~###~#~###~####~~~~#~~~
~#~~~##~####~###~#~###~####~##~~~#~
~~~#~##~####~~~~~#~~~~~####~##~#~~~
~#~~~##~~~~#~###~~~###~#~~~~##~~~#~
~#~#~##~##~~~###~#~###~~~##~##~#~#~
~~~~~~~~~~~#~~~~~~~~~~~#~~~~~~~~~~~