35 20
~~~~~~~~~~~~~~~~~~~~~~~~~~~~~~~~~~~
~####~##~#~#~##~###~##~#~#~##~####~
~####~##~~~~~~~~~#~~~~~~~~~##~####~
~###~~~#########~~~#########~~~###~
~###~#~#########~#~#########~#~###~
~~~~~#~#########~#~#########~#~~~~~
~#~#~#~#########~~~#########~#~#~#~
~#~#~~~#####################~~~#~#~
~~~~~#~#####################~#~~~~~
~#####~#####################~#####~
~###~~~~~~~#############~~~~~~~###~
~###~#####~#############~#####~###~
~~~~~~~###~#############~###~~~~~~~
~##~##~###~#############~###~##~##~
~##~##~###~#############~###~##~##~
~~~~##~~~~~#############~~~~~##~~~~
~#~###~###~#############~###~###~#~
~~~~~~~~~~~~~~~~~~~~~~~~~~~~~~~~~~~
~##~###~#~####~#####~####~#~###~##~
~~~~~~~~~~~~~~~~~~~~~~~~~~~~~~~~~~~