35 20
~~~~~~~~~~~~~#########~~~~~~~~~~~~~
~#~####~#~##~#########~##~#~####~#~
~~~~~~#~#~~~~#########~~~~#~#~~~~~~
~##~#~#~~~###############~~~#~#~##~
~~~~~~~~#~###############~#~~~~~~~~
~#~#~####~###############~####~#~#~
~#~#~####~###############~####~#~#~
~~~~~####~~~~~~#####~~~~~~####~~~~~
~###~#########~#####~#########~###~
~###~#########~#####~#########~###~
~###~#########~#####~#########~###~
~###~#########~~~~~~~#########~###~
~~~~~#########################~~~~~
~#~###########~~~~~~~###########~#~
~~~###########~##~##~###########~~~
~#~########~~~~~~~~~~~~~########~#~
~~~########~####~#~####~########~~~
~#~######~~~##~~~~~~~##~~~######~#~
~#~######~#~##~#####~##~#~######~#~
~~~~~~~~~~~~~~~~~~~~~~~~~~~~~~~~~~~