35 20
~~~~~~~#~~~~~~~~~~~~~~~~~~~#~~~~~~~
~##~##~#~###~####~####~###~#~##~##~
~##~##~#~###~####~####~###~#~##~##~
~##~~~~~~###~####~####~###~~~~~~##~
~~~~#~##~###~####~####~###~##~#~~~~
~####~~~~###~~~~~~~~~~~###~~~~####~
~####~######~#########~######~####~
~####~######~#########~######~####~
~####~######~#########~######~####~
~~~~~~######~#########~######~~~~~~
~##~########~#########~########~##~
~~~~~~~~####~##~~~~~##~####~~~~~~~~
~######~####~##~###~##~####~######~
~######~####~##~###~##~####~######~
~######~####~~~~~~~~~~~####~######~
~######~~~~~~#########~~~~~~######~
~~~~########~#########~########~~~~
~##~#####~~~~#########~~~~#####~##~
~##~#####~##~#########~##~#####~##~
~~~~~~~~~~~~~#########~~~~~~~~~~~~~